10 2
......##..
...#####..
...##.....
....##....
..........
..........
##........
###......#
###......#
.......#..
