10 2
..........
..........
.##.......
###......#
#........#
..........
..........
..........
..........
..#.......
