15 5
...##....###..#
.#.#.#...#..#.#
.....#.........
..#.##.........
..#.##.........
...##..........
...............
....##.........
...#..#........
..###.#........
..#.#..........
...............
...............
.........#.#..#
.........#..###
