10 3
..........
.####.....
#..#.#....
#....#..##
##..#..#..
..##..#...
......#...
#......##.
..........
..........
