15 4
.##.#.###......
...#.#....##...
.....#....####.
...###...####.#
#...#....#.##..
#.......#...#..
####.#..#..#.##
.####....##..##
..#..........##
##.#..#..#...##
.#.###..#......
#.#.##..##.#..#
###...##.#..#..
.#..#.##...###.
.##..##..#####.
