15 4
.#....#####....
...##.....##...
...##..........
.....#.........
....#..........
...............
####.#.........
.#.#.........##
.............##
##.#....##...##
##.#.....#...##
..#.#####...#..
###..##......#.
.####.##..#.##.
.#.#.##..#####.
